iphone67-screen-1	HomeScreen	ios	"Complete health care and_NEWLINE_benefits transactions"
1_en-US	HomeScreen	android	"Complete health care and_NEWLINE_benefits transactions"
ipadPro129-screen-1	HomeScreen	ipad	"Complete health care and_NEWLINE_benefits transactions"
iphone67-screen-2	HealthScreen	ios	"Access health care tools"
2_en-US	HealthScreen	android	"Access health care tools"
ipadPro129-screen-2	HealthScreen	ipad	"Access health care tools"
iphone67-screen-3	AppointmentDetails	ios	"Review and cancel your VA_NEWLINE_medical appointments"
3_en-US	AppointmentDetails	android	"Review and cancel your VA_NEWLINE_medical appointments"
ipadPro129-screen-3	AppointmentDetails	ipad	"Review and cancel your VA_NEWLINE_medical appointments"
iphone67-screen-4	MessagesInbox	ios	"Send and receive messages_NEWLINE_with your VA health care team"
4_en-US	MessagesInbox	android	"Send and receive messages_NEWLINE_with your VA health care team"
ipadPro129-screen-4	MessagesInbox	ipad	"Send and receive messages_NEWLINE_with your VA health care team"
iphone67-screen-8	PaymentsHistory	ios	"Review your payments history"
8_en-US	PaymentsHistory	android	"Review your payments history"
ipadPro129-screen-8	PaymentsHistory	ipad	"Review your payments history"
iphone67-screen-7	ProfileScreen	ios	"Manage your VA.gov profile"
7_en-US	ProfileScreen	android	"Manage your VA.gov profile"
ipadPro129-screen-7	ProfileScreen	ipad	"Manage your VA.gov profile"
LettersDownload_ios	LettersDownload	ios	"Download common VA letters_NEWLINE_and documents"
LettersDownload_android	LettersDownload	android	"Download common VA letters_NEWLINE_and documents"
LettersDownload_ipad	LettersDownload	ipad	"Download common VA letters_NEWLINE_and documents"
iphone67-screen-9	Prescriptions	ios	"Manage your VA prescriptions"
ipadPro129-screen-9	Prescriptions	ipad	"Manage your VA prescriptions"
iphone67-screen-6	ClaimDetails	ios	"Check claim status and upload_NEWLINE_new evidence"
6_en-US	ClaimDetails	android	"Check claim status and upload_NEWLINE_new evidence"
ipadPro129-screen-6	ClaimDetails	ipad	"Check claim status and upload_NEWLINE_new evidence"
